{
  "tiles" : [ [0, 0, 0, 0, 0, 0, 0, 0, 0 ],
              [0, 0, 0, 0, 0, 0, 0, 0, 0 ],
              [0, 0, 0, 0, 0, 0, 0, 0, 0 ],
              [0, 0, 0, 1, 1, 1, 0, 0, 0 ],
              [0, 0, 0, 1, 1, 1, 0, 0, 0 ],
              [0, 0, 0, 1, 1, 1, 0, 0, 0 ],
              [0, 0, 0, 0, 0, 0, 0, 0, 0 ],
              [0, 0, 0, 0, 0, 0, 0, 0, 0 ],
              [0, 0, 0, 0, 0, 0, 0, 0, 0 ] ],

  "targetScore" : 500,
  "moves" : 15,
}
